1 1  1 1 1 1 1 1 1 0 0 0 0 0 0 0 0 0 0 0 0 0 1 1 1 1 1 1 1 1 1 0 0 0 0 0 0 1 1 1 1 1 1 1 1 1 1 1 1 0 0 0 0 0 0 5 5 5 5 5 5 5 5 5
1 0  0 0 1 0 0 0 1 0 0 0 0 0 0 0 0 0 0 0 0 0 1 0 0 0 0 0 0 0 1 0 0 0 0 0 0 1 I 0 0 0 0 0 0 0 0 I 1 0 0 0 0 0 0 5 T 0 0 0 0 0 T 5
1 0  0 0 6 0 0 0 1 1 1 1 1 1 1 1 1 1 1 1 1 1 1 0 i 0 h 0 i 0 1 1 1 1 1 1 1 1 0 h 0 0 0 0 0 0 h 0 1 1 1 1 1 1 1 5 0 h 0 0 0 h 0 5
1 0  0 K 1 0 0 0 1 0 0 0 0 0 0 0 0 0 0 0 0 0 1 0 0 0 0 0 0 0 1 0 0 0 0 0 0 1 0 0 0 0 0 0 0 0 0 0 1 0 0 0 0 0 0 5 0 0 0 0 0 0 0 5
1 1  6 1 1 0 0 0 6 0 0 l 0 0 0 0 0 0 0 l 0 0 6 0 h 0 0 0 h 0 6 0 l 0 0 l 0 6 0 0 0 0 0 0 0 0 0 0 6 0 l 0 0 l 0 6 0 0 0 L 0 0 0 5
1 0  0 0 0 0 0 0 1 0 0 0 0 0 0 0 0 0 0 0 0 0 1 0 0 0 0 0 0 0 1 0 0 0 0 0 0 1 0 0 0 0 0 0 0 0 0 0 1 0 0 0 0 0 0 5 0 0 0 0 0 0 0 5
1 0  0 0 0 0 0 0 1 1 1 1 1 1 1 1 1 1 1 1 1 1 1 0 i 0 h 0 i 0 1 1 1 1 1 1 1 1 0 h 0 0 0 0 0 0 h 0 1 1 1 1 1 1 1 5 0 h 0 0 0 h 0 5
1 0  0 0 0 0 0 P 1 0 0 0 0 0 0 0 0 0 0 0 0 0 1 0 0 0 0 0 0 0 1 0 0 0 0 0 0 1 I 0 0 0 0 0 0 0 0 I 1 0 0 0 0 0 0 5 T 0 0 0 0 0 T 5
1 0  0 0 1 1 1 1 1 0 0 0 0 0 0 0 0 0 0 0 0 0 1 1 1 0 0 0 1 1 1 0 0 0 0 0 0 1 1 1 1 1 1 1 1 1 1 1 1 0 0 0 0 0 0 5 5 5 5 6 5 5 5 5
2 4  6 4 2 2 2 2 2 2 2 2 2 2 2 2 2 2 2 2 2 2 2 2 2 4 6 4 2 2 2 2 2 2 2 2 2 2 2 2 2 2 2 2 2 2 2 2 4 4 4 4 4 4 4 0 0 1 0 0 0 1 0 0
2 0  0 0 0 0 0 0 0 0 0 0 0 0 0 0 0 0 0 0 0 0 0 0 4 0 0 0 0 0 0 0 0 0 0 0 0 0 0 0 0 0 0 0 0 0 0 0 4 I 0 0 0 I 4 0 0 1 0 0 0 1 0 0
2 0  0 0 a 0 0 0 0 0 0 0 0 0 0 0 a 0 0 0 0 0 0 0 4 0 0 a 0 0 0 0 0 0 0 0 0 0 0 a 0 0 0 0 0 0 0 0 4 0 0 0 0 0 4 0 0 1 0 W 0 1 0 0
2 0  0 0 0 0 h 0 0 0 0 0 h 0 0 0 0 0 h 0 0 0 0 0 6 0 0 0 0 H 0 0 0 0 0 h 0 0 0 0 0 H 0 0 0 0 0 0 6 W 0 0 0 0 4 0 0 1 0 0 0 1 0 0
2 0  0 0 0 0 0 0 0 0 a 0 0 0 0 0 0 0 0 0 0 0 0 0 4 0 0 0 0 0 0 0 0 a 0 0 0 0 0 0 0 0 0 0 0 0 0 0 4 0 0 0 0 0 4 1 1 1 1 6 1 1 1 1
2 0  0 0 0 0 0 0 0 0 0 0 0 0 0 0 0 0 0 0 0 0 0 0 4 0 0 0 0 0 0 0 0 0 0 0 0 0 0 0 0 0 0 0 0 0 0 0 4 I 0 0 0 I 4 1 t 0 0 0 0 0 t 1
2 2  2 3 2 2 3 2 2 3 2 2 3 2 2 3 2 2 3 2 2 3 2 2 2 2 2 3 2 2 3 2 2 3 2 2 3 2 2 3 2 2 3 2 2 3 2 2 4 4 4 8 4 4 4 1 0 0 0 0 0 0 0 1
0 0  0 0 0 0 0 0 0 0 0 0 0 0 0 0 0 0 0 0 0 0 0 0 0 0 0 0 0 0 0 0 0 0 0 0 0 0 0 0 0 0 0 0 0 0 0 0 2 0 0 0 0 0 4 0 0 0 0 0 0 0 0 1
0 0  0 0 0 0 0 0 0 0 0 0 0 0 0 0 0 0 0 0 0 0 0 0 0 0 0 0 0 0 0 0 0 0 0 0 0 0 0 0 0 0 0 0 0 0 0 0 2 0 0 0 0 0 8 0 0 0 0 L 0 0 0 1
0 0  0 0 0 0 0 0 0 0 0 0 0 0 0 0 0 0 0 0 0 0 0 0 0 0 0 0 0 0 0 0 0 0 0 0 0 0 0 0 0 0 0 0 0 0 0 0 3 0 0 0 0 0 4 0 0 0 0 0 0 0 0 1
0 0  0 0 0 0 0 0 0 0 0 0 0 0 0 0 0 0 0 0 0 0 0 0 0 0 0 0 0 0 0 0 0 0 0 0 0 0 0 0 0 0 0 0 0 0 0 0 2 0 0 0 h 0 2 1 0 0 0 0 0 0 0 1
0 0  0 0 0 0 0 0 0 0 0 0 0 0 0 0 0 0 0 0 0 0 0 0 0 0 0 0 0 0 0 0 0 0 0 0 0 0 0 0 0 0 0 0 0 0 0 0 2 0 0 0 0 0 2 1 t 0 0 0 0 0 t 1
0 0  0 0 0 0 0 0 0 0 0 0 0 0 0 0 0 0 0 0 0 0 0 0 0 0 0 0 0 0 0 0 0 0 0 0 0 0 0 0 0 0 0 0 0 0 0 0 3 0 0 A 0 0 2 1 1 1 1 6 1 1 1 1
0 0  0 0 0 0 0 0 0 0 0 0 0 0 0 0 0 0 0 0 0 0 0 0 0 0 0 0 0 0 0 0 0 0 0 0 0 0 0 0 0 0 0 0 0 0 0 0 2 0 0 0 0 0 2 0 0 1 0 0 0 1 0 0
0 0  0 0 0 0 0 0 0 0 0 0 0 0 0 0 0 0 0 0 0 0 0 0 0 0 0 0 0 0 0 0 0 0 0 0 0 0 0 0 0 0 0 0 0 0 0 0 2 0 0 0 0 0 2 0 0 1 0 l 0 1 0 0
0 0  0 0 0 0 0 0 0 0 0 0 0 0 0 0 0 0 0 0 0 0 0 0 0 0 0 0 0 0 0 0 0 0 0 0 0 0 0 0 0 0 0 0 0 0 0 0 3 0 0 0 0 0 2 0 0 1 0 0 0 1 0 0
0 0  0 0 0 0 0 0 0 0 0 0 0 0 0 0 0 0 0 0 0 0 0 0 0 0 0 0 0 0 0 0 0 0 0 0 0 0 0 0 0 0 0 0 0 0 0 0 2 0 h 0 0 0 2 0 0 1 0 0 0 1 0 0
0 0  0 0 0 0 0 0 0 0 0 0 0 0 0 0 0 0 0 0 0 0 0 0 0 0 0 0 0 0 0 0 0 0 0 0 0 0 0 0 0 0 0 0 0 0 0 0 2 0 0 0 0 0 2 0 0 1 0 l 0 1 0 0
5 5  5 5 5 5 5 5 5 5 5 0 0 0 0 0 5 5 5 5 5 5 5 5 5 5 5 0 0 0 0 0 5 5 5 5 5 5 5 5 5 5 5 0 0 0 0 0 3 0 0 A 0 0 2 0 0 1 0 0 0 1 0 0
5 0  0 0 0 0 0 0 0 0 5 0 0 0 0 0 5 t 0 0 0 0 0 0 0 t 5 0 0 0 0 0 5 I 0 0 0 0 0 0 0 I 5 0 0 0 0 0 2 0 0 0 0 0 2 1 1 1 1 6 1 1 1 1
5 0  0 0 0 0 0 0 0 0 5 0 0 0 0 0 5 0 0 0 0 0 0 0 0 0 5 0 0 0 0 0 5 0 0 0 0 0 0 0 0 0 5 0 0 0 0 0 2 0 0 0 0 0 2 1 0 0 0 0 0 0 0 1
5 0  0 0 0 0 0 0 0 0 5 5 5 5 5 5 5 0 0 0 0 0 0 0 0 0 5 5 5 5 5 5 5 0 0 0 0 0 0 0 0 0 5 5 5 5 5 5 3 0 0 0 0 0 2 1 0 i 0 0 0 i 0 1
5 13 5 0 0 0 0 0 0 0 5 0 0 0 0 0 5 0 0 0 0 0 0 0 0 0 5 0 0 0 0 0 5 0 0 0 0 0 0 0 0 0 5 t 0 0 0 5 2 0 0 0 0 0 2 1 0 0 h 0 h 0 0 1
E 0  7 0 0 0 0 0 0 0 6 0 0 0 0 0 6 0 0 0 0 L 0 0 0 0 6 W l 0 l 0 6 0 0 0 0 L 0 0 0 0 6 W 0 h 0 5 2 0 0 G 0 0 2 1 0 0 0 0 0 0 0 1
5 13 5 0 0 0 0 0 0 0 5 0 0 0 0 0 5 0 0 0 0 0 0 0 0 0 5 0 0 0 0 0 5 0 0 0 0 0 0 0 0 0 5 t 0 l 0 5 3 0 0 0 0 0 2 1 0 0 h 0 h 0 0 1
5 0  0 0 0 0 0 0 0 0 5 5 5 5 5 5 5 0 0 0 0 0 0 0 0 0 5 5 5 5 5 5 5 0 0 0 0 0 0 0 0 0 5 5 0 h 0 5 2 0 0 0 0 0 2 1 0 i 0 0 0 i 0 1
5 0  0 0 0 0 0 0 0 0 5 0 0 0 0 0 5 0 0 0 0 0 0 0 0 0 5 0 0 0 0 0 5 0 0 0 0 0 0 0 0 0 5 5 0 0 0 5 2 0 0 0 0 0 2 1 0 0 0 0 0 0 0 1
5 0  0 0 0 0 0 0 0 0 5 0 0 0 0 0 5 t 0 0 0 0 0 0 0 t 5 0 0 0 0 0 5 I 0 0 0 0 0 0 0 I 5 5 0 0 0 5 3 0 0 0 h 0 2 1 1 1 1 6 1 1 1 1
5 5  5 5 5 5 5 5 5 5 5 0 0 0 0 0 5 5 5 5 5 5 5 5 5 5 5 0 0 0 0 0 5 5 5 5 5 5 5 5 5 5 5 5 0 h 0 5 2 0 0 0 0 0 2 0 0 1 0 0 0 1 0 0
0 0  0 0 0 0 0 0 0 0 0 0 0 0 0 0 0 0 0 0 0 0 0 0 0 0 0 0 0 0 0 0 0 0 0 0 0 0 0 0 0 0 0 5 0 l 0 5 2 0 0 S 0 0 2 0 0 1 0 l 0 1 0 0
0 0  0 0 0 0 0 0 0 0 0 0 0 0 0 0 0 0 0 0 0 0 0 0 0 0 0 0 0 0 0 0 0 0 0 0 0 0 0 0 0 0 0 5 0 h 0 5 3 0 0 0 0 0 2 0 0 1 0 W 0 1 0 0
0 0  0 0 0 0 0 0 0 0 0 0 0 0 0 0 0 0 0 0 0 0 0 0 0 0 0 0 0 0 0 0 0 0 0 0 0 0 0 0 0 0 0 5 0 0 0 5 2 0 0 0 0 0 2 0 0 1 0 0 0 1 0 0
0 0  0 0 0 0 0 0 0 0 0 0 0 0 0 0 0 0 0 0 0 0 0 0 0 0 0 0 0 0 0 0 0 0 0 0 0 0 0 0 0 0 0 5 0 0 0 5 2 0 0 0 0 0 2 0 0 1 0 l 0 1 0 0
0 0  0 0 0 0 0 0 0 0 0 0 0 0 0 0 0 0 0 0 0 0 0 0 0 0 0 0 0 0 0 0 0 0 0 0 0 0 0 0 0 0 0 5 0 h 0 5 3 0 h 0 0 0 2 0 0 1 0 0 0 1 0 0
0 0  5 5 5 5 5 5 5 5 5 5 5 5 5 5 5 5 5 5 5 5 5 5 5 5 5 5 5 5 5 5 5 5 5 5 5 5 5 5 5 5 5 5 0 l 0 5 2 0 0 0 0 0 2 1 1 1 1 6 1 1 1 1
0 0  5 0 0 0 0 0 0 0 0 0 0 0 0 0 0 0 0 0 0 0 0 0 0 0 0 0 0 0 0 0 0 0 0 0 0 0 0 0 0 0 0 0 0 h 0 5 2 0 0 A 0 0 2 1 I 0 0 0 0 0 I 1
0 0  5 0 0 0 0 l h 0 0 h l h 0 0 h l h 0 0 h l h 0 0 a l a 0 0 a l a 0 0 A l A 0 0 A l A 0 0 0 5 3 0 0 0 0 0 2 1 0 0 0 h 0 0 0 1
0 0  5 0 0 0 0 0 0 0 0 0 0 0 0 0 0 0 0 0 0 0 0 0 0 0 0 0 0 0 0 0 0 0 0 0 0 0 0 0 0 0 0 0 0 0 W 5 2 0 0 0 0 0 2 1 0 0 0 0 0 0 0 1
0 0  5 t W t 5 5 5 5 5 5 5 5 5 5 5 5 5 5 5 5 5 5 5 5 5 5 5 5 5 5 5 5 5 5 5 5 5 5 5 5 5 5 5 5 5 5 2 0 0 0 0 0 2 1 0 h 0 L 0 h 0 1
0 0  5 5 6 5 5 0 0 2 2 2 3 2 2 3 2 2 3 2 2 3 2 2 3 2 2 3 2 2 3 2 2 3 2 2 3 2 2 3 2 2 3 2 2 3 2 2 4 4 4 8 4 4 4 1 0 0 0 0 0 0 0 1
0 0  5 t 0 t 5 0 0 2 0 0 0 0 0 0 0 0 0 0 0 0 0 0 0 0 0 0 0 0 0 0 0 0 0 0 0 0 0 0 0 0 0 0 0 0 0 0 4 0 0 0 0 0 4 1 0 0 0 h 0 0 0 1
0 0  5 0 l 0 5 0 0 2 0 0 0 0 0 0 a 0 0 0 0 0 0 0 0 0 0 0 a 0 0 0 0 0 0 0 0 0 0 0 a 0 0 0 0 0 0 0 4 0 0 0 0 0 4 1 I 0 0 0 0 0 I 1
0 0  5 0 0 0 5 0 0 2 0 0 H 0 0 0 0 0 H 0 0 0 0 0 H 0 0 0 0 0 H 0 0 0 0 0 H 0 0 0 0 0 H 0 0 0 0 0 6 0 0 B 0 0 4 1 1 1 1 6 1 1 1 1
0 0  5 0 0 0 5 0 0 2 0 0 0 0 0 0 0 0 0 0 0 0 a 0 0 0 0 0 0 0 0 0 0 0 a 0 0 0 0 0 0 0 0 0 a 0 0 0 4 0 0 0 0 0 4 0 0 1 0 0 0 1 0 0
0 0  5 0 l 0 5 0 0 2 0 0 0 0 0 0 0 0 0 0 0 0 0 0 0 0 0 0 0 0 0 0 0 0 0 0 0 0 0 0 0 0 0 0 0 0 0 0 4 0 0 0 0 0 4 0 0 1 0 W 0 1 0 0
0 0  5 0 0 0 5 0 0 2 2 2 2 2 2 2 2 2 2 2 2 2 2 2 2 2 2 2 2 2 2 2 2 2 2 2 2 2 2 2 2 2 2 2 2 4 6 4 4 4 4 4 4 4 4 0 0 1 0 0 0 1 0 0
5 5  5 5 6 5 5 5 5 0 0 0 1 1 1 1 1 1 1 1 1 0 0 0 0 0 0 1 1 1 1 1 1 1 1 1 0 0 0 0 0 0 1 1 1 0 W 0 1 1 1 0 0 0 0 5 5 5 5 6 5 5 5 5
5 I  0 0 0 0 0 I 5 0 0 0 1 0 0 0 0 0 0 0 1 0 0 0 0 0 0 1 0 0 0 0 0 0 0 1 0 0 0 0 0 0 1 I 0 0 0 0 0 I 1 0 0 0 0 5 T 0 0 0 0 0 T 5
5 0  0 0 0 0 0 0 5 1 1 1 1 0 i 0 h 0 i 0 1 1 1 1 1 1 1 1 0 i 0 h 0 i 0 1 1 1 1 1 1 1 1 0 h 0 0 0 h 0 1 1 1 1 1 5 0 0 0 0 0 0 0 5
5 0  0 0 0 0 0 0 5 T 0 0 1 0 0 0 0 0 0 0 1 0 0 0 0 0 0 1 0 0 0 0 0 0 0 1 0 0 0 0 0 0 1 0 0 0 0 0 0 0 1 0 0 0 0 5 0 0 0 0 0 0 0 5
5 0  0 0 L 0 0 0 9 W 0 0 6 0 h 0 0 0 h 0 6 0 l 0 W l 0 6 0 h 0 L 0 h 0 6 0 l 0 W l 0 6 0 0 0 0 0 0 0 6 0 W 0 0 6 0 0 0 R 0 0 0 5
5 0  0 0 0 0 0 0 5 T 0 0 1 0 0 0 0 0 0 0 1 0 0 0 0 0 0 1 0 0 0 0 0 0 0 1 0 0 0 0 0 0 1 0 0 0 0 0 0 0 1 0 0 0 0 5 0 0 0 0 0 0 0 5
5 0  0 0 0 0 0 0 5 1 1 1 1 0 i 0 h 0 i 0 1 1 1 1 1 1 1 1 0 i 0 h 0 i 0 1 1 1 1 1 1 1 1 0 h 0 0 0 h 0 1 1 1 1 1 5 0 0 0 0 0 0 0 5
5 I  0 0 0 0 0 I 5 0 0 0 1 0 0 0 0 0 0 0 1 0 0 0 0 0 0 1 0 0 0 0 0 0 0 1 0 0 0 0 0 0 1 I 0 0 0 0 0 I 1 0 0 0 0 5 T 0 0 0 0 0 T 5
5 5  5 5 5 5 5 5 5 0 0 0 1 1 1 1 1 1 1 1 1 0 0 0 0 0 0 1 1 1 1 1 1 1 1 1 0 0 0 0 0 0 1 1 1 1 1 1 1 1 1 0 0 0 0 5 5 5 5 5 5 5 5 5
